村子，村庄|むら|村|名词
稻子|いね|稲|名词
雾|きり|霧|名词
城门，门，大门|もん|門|名词
舞台|ぶたい|舞台|名词
屋顶，房顶|やね|屋根|名词
琉璃瓦|るりがわら|瑠璃瓦|名词
黄色，黄颜色|きいろ|黄色|名词
天空|そら|空|名词
背景|バック|バック|名词
包租|かしきり|貸し切り|名词
一般|いっぱん|一般|名词
祖母，外婆|そぼ|祖母|名词
音乐会|おんがくかい|音楽会|名词
爵士乐|ジャズ|ジャズ|名词
露天音乐会|やがいコンサート|野外コンサート|名词
日元升值|えんだか|円高|名词
出口，输出|ゆしゅつ|輸出|名词
影响|えいきょう|影響|名词
资源|しげん|資源|名词
气温|きおん|気温|名词
海上，湖心|おき|沖|名词
海外|かいがい|海外|名词
鲸|クジラ|クジラ|名词
鲨鱼|サメ|サメ|名词
不明飞行物|ユーフォー|UFO|名词
以前|むかし|昔|名词
别名|べつめい|別名|名词
方，方面|ほう|方|名词
道路施工|どうろこうじ|道路工事|名词
上下班高峰|つうきんラッシュ|通勤ラッシュ|名词
禁止通行|つうこうきんし|通行禁止|名词
远处，远方|とおく|遠く|名词
眺望，远眺|みわたします|見渡します|动1
继续，持续|つづきます|続きます|动1
完，丢失|なくなります|なくなります|动1
生长，成长|そだちます|育ちます|动1
增加，增多|ふえます|増えます|动2
带，领|つれます|連れます|动2
缺席|けっせきします|欠席します|动3
进口，输入|ゆにゅうします|輸入します|动3
好（不）容易，特意|せっかく|せっかく|副词
绝对，一定|ぜったい|絶対|副词
是的是的|そうそう|そうそう|感叹词
紫禁城|しきんじょう|紫禁城|专有词
