数学|すうがく|数学|名词
专门|せんもん|専門|名词
女演员|じょゆう|女優|名词
营业科|えいぎょうか|営業課|名词
市内，市街，繁华街道|しがい|市街|名词
道路，马路|どうろ|道路|名词
交通流量，通行量|こうつうりょう|交通量|名词
机场|くうこう|空港|名词
高速公路|こうそくどうろ|高速道路|名词
零件制造厂|ぶひんこうじょう|部品工場|名词
电梯|エレベーター|エレベーター|名词
图画书，连环画|えほん|絵本|名词
大自然|しぜん|自然|名词
工资|きゅうりょう|給料|名词
今天晚上|こんや|今夜|名词
伤|けが|けが|名词
住，过夜，住宿|とまります|泊まります|动1
连接，系|むすびます|結びます|动1
印，记下|とります|取ります|动1
出生，诞生|うまれます|生まれます|动2
倒闭，破产|とうさんします|倒産します|动3
堵车，停滞|じゅうたいします|渋滞します|动3
确认|チェックします|チェックします|动3
充裕，丰富|ゆたか|豊か|形容动词
大的|おおきな|大きな|连接词
小的|ちいさな|小さな|连接词
并不|べつに|別に|副词
戴|たい|戴|专有词
周|しゅう|週|专有词
唐|とう|唐|专有词
中国航空|ちゅうごくこうくう|中国航空|专有词
天安饭店|てんあんはんてん|天安飯店|专有词
三环路|さんかんろ|三環路|专有词
这一带，这附近|このあたり|このあたり|惯用语
