房间，屋子|へや|部屋|名词
院子|にわ|庭|名词
家|いえ|家|名词
起居室|いま|居間|名词
冰箱|れいぞうこ|冷蔵庫|名词
墙壁|かべ|壁|名词
开关|スイッチ|スイッチ|名词
书架|ほんだな|本棚|名词
床|ベッド|ベッド|名词
猫|ねこ|猫|名词
狗|いぬ|犬|名词
盒子，箱子|はこ|箱|名词
眼镜|めがね|眼鏡|名词
录像机|ビデオ|ビデオ|名词
足球|サッカーボール|サッカーボール|名词
啤酒|ビール|ビール|名词
威士忌|ウイスキー|ウイスキー|名词
孩子，小孩|こども|子供|名词
兄弟姐妹|きょうだい|兄弟|名词
父母，双亲|りょうしん|両親|名词
妹妹|いもうと|妹|名词
男|おとこ|男|名词
女|おんな|女|名词
学生|せいと|生徒|名词
上面|うえ|上|名词
外面|そと|外|名词
里面，内部，中间|なか|中|名词
下面|した|下|名词
前，前面|まえ|前|名词
后，后面|うしろ|後ろ|名词
附近，近旁|ちかく|近く|名词
所在地，地方，场所|ばしょ|場所|名词
教室|きょうしつ|教室|名词
会议室|かいぎしつ|会議室|名词
图书室|としょしつ|図書室|名词
公园|こうえん|公園|名词
花店|はなや|花屋|名词
小卖部，售货亭|ばいてん|売店|名词
车站|えき|駅|名词
地铁|ちかてつ|地下鉄|名词
树，树木|き|樹|名词
单身生活|ひとりぐらし|一人暮らし|名词
有，在（非意志者）|あります|あります|动1
有，在（具意志者）|います|います|动2
啊，嗯|ええと|ええと|感叹词
横滨|よこはま|横浜|专有词
名古屋|なごや|名古屋|专有词
大阪|おおさか|大阪|专有词
JR|ジェーアール|ＪＲ|专有词
