围巾|マフラー|マフラー|名词
项链|ネックレス|ネックレス|名词
家具|かぐ|家具|名词
文章|ぶんしょう|文章|名词
意思|いみ|意味|名词
气氛|ふんいき|雰囲気|名词
发音|はつおん|発音|名词
房产公司|ふどうさんや|不動産屋|名词
饮食店|いんしょくてん|飲食店|名词
大使馆|たいしかん|大使館|名词
新居|しんきょ|新居|名词
搬家|ひっこし|引っ越し|名词
附近|きんじょ|近所|名词
孙子，孙女|まご|孫|名词
工作人员，主管人员|かかり|係|名词
分公司经理|ししゃちょう|支社長|名词
就业|しゅうしょく|就職|名词
互联网|インターネット|インターネット|名词
捡，拾|ひろいます|拾います|动1
翻译|やくします|訳します|动1
给|くれます|くれます|动2
送到，送去|とどけます|届けます|动2
向导，导游|あんないします|案内します|动3
换，交换|こうかんします|交換します|动3
介绍|しょうかいします|紹介します|动3
漂亮，极好|すてき|すてき|形容动词
擅长|とくい|得意|形容动词
新鲜|しんせん|新鮮|形容动词
高明地，很好地|うまく|うまく|副词
而且|それに|それに|接续词
中田|なかた|中田|专有词
国际贸易中心|こくさいぼうえきセンター|国際貿易センター|惯用语
国贸|こくぼう|国貿|专有词
没关系|どういたしまして|どういたしまして|惯用语
哪儿|どのへん|どの辺|惯用语
