提问，问题|しつもん|質問|名词
场合，情况|ばあい|場合|名词
麻烦|めいわく|迷惑|名词
紫藤|フジ|フジ|名词
喜鹊|カササギ|カササギ|名词
鸟|とり|鳥|名词
符号|マーク|マーク|名词
标记|ひょうしき|標識|名词
禁止横穿|おうだんきんし|横断禁止|名词
速度|スピード|スピード|名词
许可证，执照|めんきょしょう|免許証|名词
计划书|きかくしょ|企画書|名词
棒球场|やきゅうじょう|野球場|名词
电视讲座|テレビこうざ|テレビ講座|名词
汉字|かんじ|漢字|名词
战争|せんそう|戦争|名词
警察|けいかん|警官|名词
年长者|としうえ|年上|名词
停，停住|とまります|止まります|动1
变，转变|かわります|変わります|动1
拼命努力|がんばります|頑張ります|动1
道歉|あやまります|謝ります|动1
逃学，怠工|サボります|サボります|动1
爽约，打破|やぶります|破ります|动1
拉，抽|ひきます|引きます|动1
遵守，保护|まもります|守ります|动1
回答|こたえます|答えます|动2
逃跑|にげます|逃げます|动2
救助，帮助|たすけます|助けます|动2
添加，附加|つけます|付けます|动2
记住，掌握|おぼえます|覚えます|动2
提交，提出|ていしゅつします|提出します|动3
客气|えんりょします|遠慮します|动3
注意|ちゅういします|注意します|动3
（足球）射门，投篮|シュートします|シュートします|动3
熟悉，亲切，亲密|したしい|親しい|形容词
粗暴|らんぼう|乱暴|形容动词
不礼貌|しつれい|失礼|形容动词
一样，相同|おなじ|同じ|形容动词
危险|きけん|危険|形容动词
那样的|そんな|そんな|连接词
恭敬地；细心地|ていねいに|丁寧に|副词
哎，喂|おい|おい|感叹词
诚，阿诚|まこと|誠|专有词
周恩来|しゅうおんらい|周恩来|专有词
鲁迅|ろじん|魯迅|专有词
世田谷|せたがや|世田谷|专有词
富士|ふじ|富士|专有词
怪|かわった|変わった|惯用语
感冒|かぜをひきます|風邪を引きます|惯用语
