火车|れっしゃ|列車|名词
高速公共汽车|こうそくバス|高速バス|名词
出发时间|しゅっぱつじこく|出発時刻|名词
旅行计划|りょこうよてい|旅行予定|名词
天气预报|てんきよほう|天気予報|名词
台风|たいふう|台風|名词
传说，风言风语|うわさ|うわさ|名词
宣传|せんでん|宣伝|名词
节目|ばんぐみ|番組|名词
新型|しんがた|新型|名词
奖金|ボーナス|ボーナス|名词
面条|ラーメン|ラーメン|名词
牛奶|ぎゅうにゅう|牛乳|名词
饺子宴|ギョーザパーティー|饺子パーティー|名词
新年假日|しょうがつやすみ|正月休み|名词
体育用品|スポーツようひん|スポーツ用品|名词
流感，流行性感冒|インフルエンザ|インフルエンザ|名词
分店，分公司|してん|支店|名词
小学|しょうがっこう|小学校|名词
游乐园|ゆうえんち|遊園地|名词
首相|しゅしょう|首相|名词
历史|れきし|歴史|名词
她|かのじょ|彼女|代词
开，举行|おこないます|行います|动1
提高，涨|あがります|上がります|动1
换乘|のりかえます|乗り換えます|动2
辞去|やめます|辞めます|动2
留学|りゅうがくします|留学します|动3
入学|にゅうがくします|入学します|动3
流行|りゅうこうします|流行します|动3
住院|にゅういんします|入院します|动3
打扰，拜访|おじゃまします|お邪魔します|动3
承担|たんとうします|担当します|动3
强，坚强|つよい|強い|形容词
爽快，坦率|きさく|気さく|形容动词
各种各样的|いろんな|いろんな|连接词
一直，始终|ずっと|ずっと|副词
刘英|りゅうえい|劉英|专有词
泰国|タイ|タイ|专有词
京都宾馆|きょうとホテル|京都ホテル|专有词
打扰了|おじゃましました|お邪魔しました|惯用语
风大|かぜがつよい|風が強い|惯用语
