西服|ようふく|洋服|名词
毛衣|セーター|セーター|名词
笔记本电脑|ノートパソコン|ノートパソコン|名词
摩托车|バイク|バイク|名词
年糕小豆汤|おしるこ|お汁粉|名词
天麸罗|てんぷら|天ぷら|名词
新年后首次参拜|はつもうで|初詣|名词
健康|けんこう|健康|名词
恋爱|れんあい|恋愛|名词
连续剧|ドラマ|ドラマ|名词
对象，对方|あいて|相手|名词
恋人|こいびと|恋人|名词
前辈|せんぱい|先輩|名词
男性|だんせい|男性|名词
外国人|がいこくじん|外国人|名词
夏天|なつ|夏|名词
开始|はじめます|始めます|动2
联系|れんらくします|連絡します|动3
想要|ほしい|欲しい|形容词
美观，杰出|りっぱ|立派|形容动词
下次；这回|こんど|今度|副词
一定|ぜひ|ぜひ|副词
快要|そろそろ|そろそろ|副词
先，首先|まず|まず|副词
贝多芬|ベートーベン|ベートーベン|专有词
肖邦|ショパン|ショパン|专有词
故宫|こきゅう|故宮|专有词
欧洲|ヨーロッパ|ヨーロッパ|专有词
香港|ホンコン|香港|专有词
瑞士|スイス|スイス|专有词
