中国人|ちゅうごくじん|中国人|名词
日本人|にほんじん|日本人|名词
韩国人|かんこくじん|韓国人|名词
美国人|アメリカじん|アメリカ人|名词
法国人|フランスじん|フランス人|名词
（大）学生|がくせい|学生|名词
老师|せんせい|先生|名词
留学生|りゅうがくせい|留学生|名词
教授|きょうじゅ|教授|名词
职员|しゃいん|社員|名词
公司职员|かいしゃいん|会社員|名词
店员|てんいん|店員|名词
进修生|けんしゅうせい|研修生|名词
企业|きぎょう|企業|名词
大学|だいがく|大学|名词
（我）父亲|ちち|父|名词
科长|かちょう|課長|名词
总经理，社长|しゃちょう|社長|名词
迎接|でむかえ|出迎え|名词
那个人|あのひと|あの人|名词
我|わたし|わたし|代词
你|あなた|あなた|代词
非常，很|どうも|どうも|副词
哎，是|はい|はい|感叹词
不，不是|いいえ|いいえ|感叹词
哎，哎呀|あっ|あっ|感叹词
李|り|李|专有词
王|おう|王|专有词
张|ちょう|張|专有词
森|もり|森|专有词
林|はやし|林|专有词
小野|おの|小野|专有词
吉田|よしだ|吉田|专有词
田中|たなか|田中|专有词
中村|なかむら|中村|专有词
太郎|たろう|太郎|专有词
金|キム|金|专有词
迪蓬|デュポン|デュポン|专有词
史密斯|スミス|スミス|专有词
约翰逊|ジョンソン|ジョンソン|专有词
中国|ちゅうごく|中国|专有词
东京大学|とうきょうだいがく|東京大学|专有词
北京大学|ペキンだいがく|北京大学|专有词
JC策划公司|ジェーシーきかく|ＪＣ企画|专有词
北京旅行社|ペキンりょこうしゃ|北京旅行社|专有词
日中商社|にっちゅうしょうじ|日中商事|专有词
你好|こんにちは|こんにちは|惯用语
对不起，请问|すみません|すみません|惯用语
请|どうぞ|どうぞ|惯用语
请多关照|よろしくおねがいします|よろしくお願いします|惯用语
初次见面|はじめまして|はじめまして|惯用语
我才要（请您～）|こちらこそ|こちらこそ|惯用语
是（这样）|そうです|そうです|惯用语
不是|ちがいます|ちがいます|惯用语
不知道|わかりません|分かりません|惯用语
实在对不起|どうもすみません|どうもすみません|惯用语
