物品，商品|しなもの|品物|名词
盘子|おさら|お皿|名词
垃圾|ごみ|ごみ|名词
初学者|しょしんしゃ|初心者|名词
熟练者|じょうきゅうしゃ|上級者|名词
高级|こうきゅう|高級|名词
高级班|じょうきゅうクラス|上級クラス|名词
英语会话|えいかいわ|英会話|名词
路线，滑道|コース|コース|名词
滑雪|スキー|スキー|名词
报告|レポート|レポート|名词
护照|パスポート|パスポート|名词
喉咙|のど|のど|名词
碰，触|さわります|触ります|动1
脱|ぬぎます|脱ぎます|动1
摔，摔倒，跌倒|ころびます|転びます|动1
渴|かわきます|渇きます|动1
痊愈，医好|なおります|治ります|动1
滑，滑行|すべります|滑ります|动1
呼喊|よびます|呼びます|动1
归还|かえします|返します|动1
帮忙|てつだいます|手伝います|动1
搬运|はこびます|運びます|动1
丢，丢失|なくします|なくします|动1
掉，使落下|おとします|落とします|动1
放置|おきます|置きます|动1
支付|はらいます|払います|动1
站，立|たちます|立ちます|动1
忘记|わすれます|忘れます|动2
慌张，惊慌，着急|あわてます|慌てます|动2
扔，扔掉|すてます|捨てます|动2
加班|ざんぎょうします|残業します|动3
担心|しんぱいします|心配します|动3
真的，真正|ほんとう|本当|形容动词
早点儿|はやく|早く|副词
好不容易，终于|やっと|やっと|副词
很，相当地|だいぶ|だいぶ|副词
第一次|はじめて|初めて|副词
先|さきに|先に|副词
山田|やまだ|山田|专有词
