下个月|らいげつ|来月|名词
上个月|せんげつ|先月|名词
午夜，半夜|よなか|夜中|名词
昨天晚上|ゆうべ|ゆうべ|名词
音乐会|コンサート|コンサート|名词
圣诞节|クリスマス|クリスマス|名词
生日|たんじょうび|誕生日|名词
儿童节|こどものひ|こどもの日|名词
暑假|なつやすみ|夏休み|名词
交通工具|こうつうきかん|交通機関|名词
新干线|しんかんせん|新幹線|名词
飞机|ひこうき|飛行機|名词
渡轮|フェリー|フェリー|名词
电车|でんしゃ|電車|名词
公共汽车|バス|バス|名词
出租车|タクシー|タクシー|名词
美术馆|びじゅつかん|美術館|名词
公寓|アパート|アパート|名词
家|うち|うち|名词
游泳池|プール|プール|名词
朋友|ともだち|友達|名词
弟弟|おとうと|弟|名词
去|いきます|行きます|动1
回来，回去|かえります|帰ります|动1
来|きます|来ます|动3
好像是，大概；的确|たしか|たしか|副词
径直，笔直|まっすぐ|まっすぐ|副词
一起|いっしょに|いっしょに|副词
佐藤|さとう|佐藤|专有词
北京|ペキン|北京|专有词
美国|アメリカ|アメリカ|专有词
韩国|かんこく|韓国|专有词
法国|フランス|フランス|专有词
广岛|ひろしま|広島|专有词
京都|きょうと|京都|专有词
北海道|ほっかいどう|北海道|专有词
箱根|はこね|箱根|专有词
银座|ぎんざ|銀座|专有词
涩谷|しぶや|渋谷|专有词
新宿|しんじゅく|新宿|专有词
够累的|おつかれさまでした|お疲れ様でした|惯用语
我先走了，我先告辞了|おさきにしつれいします|お先に失礼します|惯用语
步行|あるいて|歩いて|惯用语
真不容易，够受的，不得了|たいへんですね|大変ですね|惯用语
