季节|きせつ|季節|名词
冬天，冬季|ふゆ|冬|名词
春天，春季|はる|春|名词
日式饭菜|にほんりょうり|日本料理|名词
寿司|すし|寿司|名词
梨|ナシ|ナシ|名词
香蕉|バナナ|バナナ|名词
橘子|ミカン|ミカン|名词
烧酒|しょうちゅう|焼酎|名词
日本酒|にほんしゅ|日本酒|名词
红茶|こうちゃ|紅茶|名词
乌龙茶|ウーロンちゃ|ウーロン茶|名词
茉莉花茶|ジャスミンちゃ|ジャスミン茶|名词
绿茶|りょくちゃ|緑茶|名词
果汁|ジュース|ジュース|名词
声望，受欢迎|にんき|人気|名词
座位，席位|せき|席|名词
班级|クラス|クラス|名词
种类|しゅるい|種類|名词
个子|せ|背|名词
哥哥，兄长|あに|兄|名词
最近，近来|さいきん|最近|名词
下（雨，雪），降（雨，雪）|ふります|降ります|动1
年轻|わかい|若い|形容词
暖和，温暖|あたたかい|暖かい|形容词
凉爽|すずしい|涼しい|形容词
快|はやい|速い|形容词
非常喜欢|だいすき|大好き|形容动词
最，第一|いちばん|いちばん|副词
～得多|ずっと|ずっと|副词
仍然，还是|やはり|やはり|副词
仍然，还是|やっぱり|やっぱり|副词
珠穆朗玛峰|エベレスト|エベレスト|专有词
受欢迎|にんきがあります|人気があります|惯用语
