大雨|おおあめ|大雨|名词
樱花|さくら|桜|名词
风|かぜ|風|名词
月亮|つき|月|名词
表|ひょう|表|名词
握手|あくしゅ|握手|名词
习惯|しゅうかん|習慣|名词
鞠躬|おじぎ|お辞儀|名词
寒暄|あいさつ|あいさつ|名词
手|て|手|名词
顾客，客人|おきゃくさん|お客さん|名词
一般，普通|ふつう|普通|名词
这回，下面，下回|つぎ|次|名词
超市|スーパー|スーパー|名词
费用|りょうきん|料金|名词
会费|かいひ|会費|名词
降价出售|バーゲン|バーゲン|名词
信用卡|クレジットカード|クレジットカード|名词
彩色铅笔|いろえんぴつ|色鉛筆|名词
丰收|ほうさく|豊作|名词
关系，友情，友谊|なか|仲|名词
忘记的东西，遗忘的物品|わすれもの|忘れ物|名词
防御，防备，防守|ふせぎます|防ぎます|动1
走访；转；绕弯|まわります|回ります|动1
跑，奔跑|はしります|走ります|动1
吹|ふきます|吹きます|动1
举，举起|あげます|挙げます|动2
足，够|たります|足ります|动2
素描，写生|スケッチします|スケッチします|动3
发言|はつげんします|発言します|动3
得冠军|ゆうしょうします|優勝します|动3
及格，合格|ごうかくします|合格します|动3
也许|もしかしたら|もしかしたら|副词
约定|やくそくします|約束します|动3
不知不觉地，无意中|つい|つい|副词
就要，立刻，马上|すぐに|すぐに|副词
大部分，几乎|ほとんど|ほとんど|副词
因此|それで|それで|接续词
铃木|すずき|鈴木|专有词
杨|よう|楊|专有词
加藤|かとう|加藤|专有词
叶子|ようこ|葉子|专有词
阳光百货商店|ひかりデパート|光デパート|专有词
北京猛虎队＜棒球队名称＞|ペキンタイガース|北京タイガース|专有词
寒暄拜访|あいさつまわり|あいさつ回り|惯用语
不行，不好，不可以|いけない|いけない|惯用语
