经济|けいざい|経済|名词
国际关系学|こくさいかんけいがく|国際関係学|名词
许多，众多|おおぜい|大勢|名词
高中|こうこう|高校|名词
日记|にっき|日記|名词
教师|きょうし|教師|名词
老年人|おとしより|お年寄り|名词
广播体操|ラジオたいそう|ラジオ体操|名词
交际舞|しゃこうダンス|社交ダンス|名词
乒乓球|たっきゅう|卓球|名词
篮球|バスケットボール|バスケットボール|名词
体育中心|スポーツセンター|スポーツセンター|名词
门票，入园费|にゅうえんりょう|入園料|名词
收费|ゆうりょう|有料|名词
奖|しょう|賞|名词
乐曲，歌曲|きょく|曲|名词
诗歌|し|詩|名词
信号，红绿灯|しんごう|信号|名词
剪刀|はさみ|はさみ|名词
零部件|ぶひん|部品|名词
打工，副业，工读|アルバイト|アルバイト|名词
演说，演讲|スピーチ|スピーチ|名词
图表|グラフ|グラフ|名词
策划，计划|きかく|企画|名词
说明|せつめい|説明|名词
饭|ごはん|ご飯|名词
砂糖|さとう|砂糖|名词
海外旅行|かいがいりょこう|海外旅行|名词
事情|こと|こと|名词
爷爷；老大爷|おじいさん|おじいさん|代词
奶奶；老奶奶|おばあさん|おばあさん|代词
姐姐|あね|姉|代词
上学，来往|かよいます|通います|动1
聚，集合|あつまります|集まります|动1
跳舞|おどります|踊ります|动1
要|いります|要ります|动1
为难，难办|こまります|困ります|动1
拍，敲，打|たたきます|たたきます|动1
放入，放进|いれます|入れます|动2
护理|かんびょうします|看病します|动3
吵架，打架|けんかします|けんかします|动3
利用|りようします|利用します|动3
商谈|そうだんします|そうだんします|动3
另外|ほかに|ほかに|副词
许久，好久；片刻|しばらく|しばらく|副词
哎，哎呀，哎哟|へえ|へえ|感叹词
木下|きのした|木下|专有词
田村|たむら|田村|专有词
前几天，之前，最近|このまえ|この前|惯用语
说起来，这么说来|そういえば|そう言えば|惯用语
察觉|きがつきます|気がつきます|惯用语
好久不见|しばらくです|しばらくです|惯用语
