声音，响声|おと|音|名词
声音|こえ|声|名词
空气|くうき|空気|名词
儿子|むすこ|息子|名词
医生|いしゃ|医者|名词
令爱|おじょうさん|お嬢さん|名词
社会的一员，成人|しゃかいじん|社会人|名词
旅行导游|りょこうガイド|旅行ガイド|名词
学者|がくしゃ|学者|名词
飞行员|パイロット|パイロット|名词
设计者，设计家|デザイナー|デザイナー|名词
时段廉价销售|タイムサービス|タイムサービス|名词
新年大甩卖|しんしゅんセール|新春セール|名词
七折|さんわりびき|３割引|名词
定价|ていか|定価|名词
半价|はんがく|半額|名词
价格|ねだん|値段|名词
衬衫|シャツ|シャツ|名词
裙子|スカート|スカート|名词
颜色|いろ|色|名词
红色|あか|赤|名词
蓝色|あお|青|名词
过年，新年|おしょうがつ|お正月|名词
时间|じかん|時間|名词
将来|しょうらい|将来|名词
准备|じゅんび|準備|名词
疾病|びょうき|病気|名词
变，当，变成，成为|なります|なります|动1
开|あきます|開きます|动1
适合，相称|にあいます|似合います|动1
闹，使人心烦|うるさい|うるさい|形容词
单纯，简洁|シンプル|シンプル|形容动词
马上，一会儿，不久|まもなく|間もなく|副词
更加，更|さらに/もっと|さらに/もっと|副词
啊，喂|さあ|さあ|感叹词
尽量，尽可能|できるだけ|できるだけ|惯用语
一下子，一起，汇总，汇集|まとめて|まとめて|惯用语
从现在起|いまから|今から|惯用语
