礼物|プレゼント|プレゼント|名词
票|チケット|チケット|名词
小册子|パンフレット|パンフレット|名词
纪念品|きねんひん|記念品|名词
日程表|スケジュールひょう|スケジュール表|名词
影集|しゃしんしゅう|写真集|名词
花|はな|花|名词
钱，金钱|おかね|お金|名词
圆珠笔|ボールペン|ボールペン|名词
作业|しゅくだい|宿題|名词
航空邮件|こうくうびん|航空便|名词
速递，快件|そくたつ|速達|名词
传真|ファックス|ファックス|名词
邮件|メール|メール|名词
电话号码|でんわばんごう|電話番号|名词
住址|じゅうしょ|住所|名词
姓名|なまえ|名前|名词
事件，事情|けん|件|名词
报纸|しんぶんし|新聞紙|名词
纸折的飞机|かみひこうき|紙飛行機|名词
巧克力|チョコレート|チョコレート|名词
冰激凌|アイスクリーム|アイスクリーム|名词
面粉|こむぎこ|小麦粉|名词
筷子|はし|はし|名词
勺子|スプーン|スプーン|名词
哥哥|おにいさん|お兄さん|名词
韩语|かんこくご|韓国語|名词
傍晚|ゆうがた|夕方|名词
午休|ひるやすみ|昼休み|名词
拿到，得到|もらいます|もらいます|动1
见|あいます|会います|动1
寄|おくります|送ります|动1
做，制造|つくります|作ります|动1
胖|ふとります|太ります|动1
寄（信）|だします|出します|动1
收到，送到，寄到|とどきます|届きます|动1
画|かきます|かきます|动1
借出，借给|かします|貸します|动1
学习|ならいます|習います|动1
给|あげます|あげます|动2
打（电话）|かけます|かけます|动2
（向别人）借|かります|借ります|动2
教|おしえます|教えます|动2
已经|もう|もう|副词
刚才|さっき|さっき|副词
刚刚|たったいま|たった今|副词
再一次|もういちど|もう一度|副词
以前|まえに|前に|副词
陈|ちん|陳|专有词
怎样，如何|どうですか|どうですか|惯用语
拜托了|おねがいします|お願いします|惯用语
明白了|わかりました|分かりました|惯用语
太好了|よかったです|よかったです|惯用语
