红叶|もみじ|紅葉|名词
故乡|こきょう|故郷|名词
大街|とおり|通り|名词
城市，街道|まち|町|名词
场所|ところ|所|名词
餐馆；商店|おみせ|お店|名词
玩偶|にんぎょう|人形|名词
作品|さくひん|作品|名词
雕刻|ちょうこく|彫刻|名词
汽车|じどうしゃ|自動車|名词
工具|どうぐ|道具|名词
鱼|さかな|魚|名词
点心|おかし|お菓子|名词
物品，东西|もの|物|名词
季节|シーズン|シーズン|名词
修学旅行|しゅうがくりょこう|修学旅行|名词
游客|かんこうきゃく|観光客|名词
作家|さっか|作家|名词
部长|ぶちょう|部長|名词
平日，非休息日|へいじつ|平日|名词
日子|ひ|日|名词
生活|せいかつ|生活|名词
世界|せかい|世界|名词
晴天|はれ|晴れ|名词
雨，下雨|あめ|雨|名词
阴天|くもり|曇り|名词
雪|ゆき|雪|名词
脏|きたない|汚い|形容词
漂亮，干净|きれい|きれい|形容动词
有名|ゆうめい|有名|形容动词
热闹，繁华|にぎやか|にぎやか|形容动词
安静|しずか|静か|形容动词
空闲|ひま|暇|形容动词
热情|しんせつ|親切|形容动词
喜欢|すき|好き|形容动词
讨厌|きらい|嫌い|形容动词
方便|べんり|便利|形容动词
不方便|ふべん|不便|形容动词
健康，有精神|げんき|元気|形容动词
简单|かんたん|簡単|形容动词
英俊，帅气|ハンサム|ハンサム|形容动词
什么样的，怎样的|どんな|どんな|代词
怎样，如何|どう|どう|副词
如何|いかが|いかが|副词
各种各样|いろいろ|いろいろ|副词
可是，不过|でも|でも|接续词
而且，于是|そして|そして|接续词
（转换话题）哎|ところで|ところで|接续词
咦|あれえ|あれえ|感叹词
奈良|なら|奈良|专有词
富士山|ふじさん|富士山|专有词
再～一点|もうすこし|もう少し|惯用语
