送货上门服务|たくはいびん|宅配便|名词
报告书|ほうこくしょ|報告書|名词
梅雨|つゆ|梅雨|名词
秋天，秋季|あき|秋|名词
郊游|ピクニック|ピクニック|名词
景点，浏览地|こうらくち|行楽地|名词
比萨饼|ピザ|ピザ|名词
末班电车|しゅうでん|終電|名词
候诊室，等候室|まちあいしつ|待合室|名词
病人，患者|かんじゃ|患者|名词
烟灰缸|はいざら|灰皿|名词
烟头，烟灰，烟蒂|すいがら|吸殻|名词
牙齿|は|歯|名词
他|かれ|彼|代词
到齐，齐全|そろいます|そろいます|动1
顺便去；靠近|よります|寄ります|动1
开，开张|ひらきます|開きます|动1
迎接|むかえます|迎えます|动2
搬迁|ひっこします|引っ越します|动1
出故障，坏|こわれます|壊れます|动2
搞错|まちがえます|間違えます|动2
出发|しゅっぱつします|出発します|动3
换工作|てんしょくします|転職します|动3
轮胎爆裂，撑破|パンクします|パンクします|动3
寂寞|さびしい|寂しい|形容词
愉快，期待|たのしみ|楽しみ|形容动词
特别|とくべつ|特別|形容动词
那么|それでは/それじゃ|それでは／それじゃ|接续词
是吗|そうか|そうか|感叹词
嗯，嘿，哎哟|まあ|まあ|感叹词
朴|パク|パク|专有词
坐船浏览长江两岸风光|ちょうこうくだり|長江下り|专有词
香山|こうざん|香山|专有词
北京植物园|ペキンしょくぶつえん|北京植物園|专有词
没有办法|しかたない|仕方ない|惯用语
