孩子减少现象|しょうしか|少子化|名词
人口|じんこう|人口|名词
平均年龄|へいきんねんれい|平均年齢|名词
交通|こうつう|交通|名词
方便，便利|べん|便|名词
连接，衔接|アクセス|アクセス|名词
磁悬浮列车|リニアモーターカー|リニアモーターカー|名词
航班|びん|便|名词
市内|しない|市内|名词
乡下，农村|いなか|田舎|名词
中心地区|ちゅうしんち|中心地|名词
现代化|きんだいか|近代化|名词
现代人|げんだいじん|現代人|名词
时间段|じかんたい|時間帯|名词
情况，状况；势头|ちょうし|調子|名词
长处，好处|よさ|よさ|名词
房租|へやだい|部屋代|名词
森林|しんりん|森林|名词
地球|ちきゅう|地球|名词
平均气温|へいきんきおん|平均気温|名词
地球变暖现象|ちきゅうおんだんか|地球温暖化|名词
冷冻食品|れいとうしょくひん|冷凍食品|名词
高龄者|こうれいしゃ|高齢者|名词
吸烟者|きつえんしゃ|喫煙者|名词
旅行者|りょこうしゃ|旅行者|名词
利用者|りようしゃ|利用者|名词
烦恼|なやみ|悩み|名词
市容，街道，街景|まちなみ|町並み|名词
销售额，营业额|うりあげ|うりあげ|名词
憧憬|あこがれ|あこがれ|名词
加重，前进|すすみます|進みます|动1
刷，擦|みがきます|磨きます|动1
天阴|くもります|曇ります|动1
像，相似|にます|似ます|动2
景观照明|ライトアップします|ライトアップします|动3
普及|ふきゅうします|普及します|动3
避雨|あまやどりします|雨宿りします|动3
残酷，过分；激烈|ひどい|ひどい|形容词
简便，简单，轻便|てがる|手軽|形容动词
迅速，快速|きゅうそく|急速|形容动词
以前|いぜん|以前|副词
连接不断地，接二连三地|どんどん|どんどん|副词
越来越，更加|ますます|ますます|副词
有点，总觉得，有些，好像|なんか|なんか|副词
逐年，每年|ねんねん|年々|副词
清淡的或少量的食物|かるいもの|軽い物|惯用语
