咖啡|コーヒー|コーヒー|名词
可乐|コーラ|コーラ|名词
茶|おちゃ|お茶|名词
葡萄酒|ワイン|ワイン|名词
面包|パン|パン|名词
蛋糕|ケーキ|ケーキ|名词
粥|おかゆ|お粥|名词
午饭|ひるごはん|昼ご飯|名词
盒饭|おべんとう|お弁当|名词
荞麦面|そば|そば|名词
面条|うどん|うどん|名词
鸡肉鸡蛋盖饭|おやこどん|親子丼|名词
咖喱（饭）|カレー|カレー|名词
鸡蛋|たまご|卵|名词
干酪|チーズ|チーズ|名词
苹果|リンゴ|リンゴ|名词
草莓|イチゴ|イチゴ|名词
荞麦面馆|そばや|そば屋|名词
网球|テニス|テニス|名词
慢跑，跑步|ジョギング|ジョギング|名词
足球|サッカー|サッカー|名词
棒球|やきゅう|野球|名词
申请书|もうしこみしょ|申込書|名词
信|てがみ|手紙|名词
CD|シーディー|ＣＤ|名词
音乐|おんがく|音楽|名词
电影|えいが|映画|名词
动物园|どうぶつえん|動物園|名词
熊猫|パンダ|パンダ|名词
喝|のみます|飲みます|动1
买|かいます|買います|动1
拍照，拍摄|とります|撮ります|动1
写|かきます|書きます|动1
读|よみます|読みます|动1
听|ききます|聞きます|动1
吃|たべます|食べます|动2
看|みます|見ます|动2
干，做|します|します|动3
打扫，扫除|そうじします|掃除します|动3
从现在起，今后|これから|これから|副词
那么|じゃあ|じゃあ|接续词
那么|では|では|接续词
欢迎光临|いらっしゃいませ|いらっしゃいませ|惯用语
告辞了，我走了|しつれいします|失礼します|惯用语
打搅了，失礼了|しつれいしました|失礼しました|惯用语
我走了|いってまいります|いってまいります|惯用语
我走了|いってきます|いってきます|惯用语
你走好|いってらっしゃい|いってらっしゃい|惯用语
我回来了|ただいま|ただいま|惯用语
你回来了|おかえりなさい|お帰りなさい|惯用语
我知道了|かしこまりました|かしこまりました|惯用语
打扰了|おじゃまします|お邪魔します|惯用语
给我|ください|ください|惯用语
上午|ごぜんちゅう|午前中|惯用语
