菜肴，饭菜|りょうり|料理|名词
四川菜|しせんりょうり|四川料理|名词
汤|スープ|スープ|名词
北京烤鸭|ペキンダック|北京ダック|名词
食物，食品|たべもの|食べ物|名词
日式牛肉火锅|すきやき|すき焼き|名词
温泉|おんせん|温泉|名词
热水，开水|おゆ|お湯|名词
水，凉水|みず|水|名词
浴衣，夏季和服|ゆかた|浴衣|名词
景色，风景|ながめ|眺め|名词
药|くすり|薬|名词
天气|てんき|天気|名词
大海|うみ|海|名词
山|やま|山|名词
纸|かみ|紙|名词
新闻|ニュース|ニュース|名词
女性|じょせい|女性|名词
来宾|おきゃくさま|お客様|名词
玻璃杯|グラス|グラス|名词
歌舞伎|かぶき|歌舞伎|名词
心情|きもち|気持ち|名词
很多|たくさん|たくさん|名词
辣|からい|辛い|形容词
甜|あまい|甘い|形容词
咸|しおからい|塩辛い|形容词
咸|しょっぱい|しょっぱい|形容词
酸|すっぱい|酸っぱい|形容词
苦|にがい|苦い|形容词
好吃，可口|おいしい|おいしい|形容词
不好吃，难吃|まずい|まずい|形容词
热，烫|あつい|あつい|形容词
凉|つめたい|冷たい|形容词
愉快，快乐|たのしい|楽しい|形容词
有趣，有意思|おもしろい|おもしろい|形容词
无聊|つまらない|つまらない|形容词
广阔，宽敞|ひろい|広い|形容词
狭窄|せまい|狭い|形容词
大|おおきい|大きい|形容词
小|ちいさい|小さい|形容词
忙，忙碌|いそがしい|忙しい|形容词
好|いい|いい|形容词
不好，坏|わるい|悪い|形容词
极好，绝佳|すばらしい|すばらしい|形容词
远|とおい|遠い|形容词
近|ちかい|近い|形容词
高，贵|たかい|高い|形容词
低|ひくい|低い|形容词
便宜|やすい|安い|形容词
寒冷|さむい|寒い|形容词
（天气）热|あつい|暑い|形容词
蓝色的|あおい|青い|形容词
白色的|しろい|白い|形容词
新|あたらしい|新しい|形容词
旧|ふるい|古い|形容词
难|むずかしい|難しい|形容词
容易|やさしい|易しい|形容词
多|おおい|多い|形容词
少|すくない|少ない|形容词
可爱|かわいい|かわいい|形容词
真的，实在是|ほんとうに|本当に|副词
不（太）～，不很～|あまり|あまり|副词
很，非常|とても|とても|副词
很，非常|たいへん|たいへん|副词
一点儿|すこし|少し|副词
一点儿|ちょっと|ちょっと|副词
根本|ぜんぜん|全然|副词
正好，恰好|ちょうど|ちょうど|副词
哎呀，咦|あら|あら|感叹词
哎呀，咦|あれ|あれ|感叹词
啊|ああ|ああ|感叹词
天安门|てんあんもん|天安門|专有词
万里长城|ばんりのちょうじょう|万里の長城|专有词
感觉舒服，心情愉快|きもちがいい|気持ちがいい|惯用语
