爱好|しゅみ|趣味|名词
特长，拿手的技术|とくぎ|特技|名词
兴趣|きょうみ|興味|名词
梦，理想|ゆめ|夢|名词
吉他|ギター|ギター|名词
胡琴|こきゅう|胡弓|名词
书法|しょどう|書道|名词
钓鱼|つり|釣り|名词
兜风，开汽车远游|ドライブ|ドライブ|名词
编制；编织品|あみもの|編み物|名词
手工做，自己做，手制|てづくり|手作り|名词
中华街|ちゅうかがい|中華街|名词
中国菜|ちゅうかりょうり|中華料理|名词
饺子|ギョーザ|餃子|名词
皮|かわ|皮|名词
春节|しゅんせつ|春節|名词
狮子舞|ししまい|獅子舞|名词
宿舍|りょう|寮|名词
洗衣机|せんたくき|洗濯機|名词
淋浴|シャワー|シャワー|名词
肚子|おなか|おなか|名词
授课，上课|じゅぎょう|授業|名词
资料|しりょう|資料|名词
法语|フランスご|フランス語|名词
小说|しょうせつ|小説|名词
海岸|かいがん|海岸|名词
寒假|ふゆやすみ|冬休み|名词
野营|キャンプ|キャンプ|名词
大家|みんな|みんな|名词
自己|じぶん|自分|名词
全员|ぜんいん|全員|名词
弹|ひきます|弾きます|动1
（肚子）饿，空|すきます|すきます|动1
登，上|のぼります|登ります|动1
收集|あつめます|集めます|动2
淋；浇|あびます|浴びます|动2
请客，摆盛宴|ごちそうします|ごちそうします|动3
回国|きこくします|帰国します|动3
特别|とくに|特に|副词
肚子饿|おなかがすきます|おなかがすきます|惯用语
