机场|くうこう|空港
决定，确定|けってい|決定
恭喜|おめでとうございます|おめでとうございます
来日本|らいにち|来日
到达|とうちゃく|到着
几点|なんじ|何時
预定、计划|よてい|予定
迎接|むかえ|迎え
门厅、前厅|ロビー|ロビー
回、回去|かえる|帰る
就业|しゅうしょく|就職
贸易|ぼうえき|貿易
使用|つかう|使う
加班|ざんぎょう|ざんぎょう
每天|ひび|日々
令人怀念|なつかしい|懐かしい
住所|じゅうきょ|住居
绝对（不）|けっして|決して
担心|しんぱいだ|心配だ
需要|いる|いる
便宜|やすい|安い
公寓|アパート|アパート
介绍|しょうかい|紹介
放心|あんしんだ|安心だ
那么（较正式）|では|では
健康|げんきだ|元気だ
（接人名后）表示敬意|さま|様
西餐馆|レストラン|レストラン
嗓子|のど|喉
渴|かわく|渇く
喝|のむ|飲む
富士山|ふじさん|富士山
极美，绝好|すばらしい|素晴らしい
笑|わらう|笑う
喂，那个|あの|あの
洗手间|おてあらい|お手洗い
等待|まつ|待つ