海外|かいがい|海外
旅行|りょこう|旅行
罕见，稀奇|めずらしい|珍しい
事情|こと|事
例如|たとえば|例えば
新婚|しんこん|新婚
国内|こくない|国内
选择|えらぶ|選ぶ
少|すくない|少ない
想，认为|おもう|思う
多，多数|おおく|多く
情侣，夫妇|カップル|カップル
夏威夷|ハワイ|ハワイ
欧洲|ヨーロッパ|ヨーロッパ
说，讲|いう|言う
各地|かくち|各地
短期|たんき|短期
homestay|ホームステイ|ホームステイ
个人|こじん|個人
许多（人）|おおぜい|大勢
国家|くに|国
方面|ほう|方
价格，价钱|ねだん|値段
场合，情形|ばあい|場合
签证|ビザ|ビザ
不需要|ふようだ|不要だ
简单，简略|かんたんだ|簡単だ
然而，但是|しかし|しかし
拼命，努力|いっしょうけんめいだ|一生懸命だ
学习|べんきょう|勉強
贵重，宝贵|きちょうだ|貴重だ
青春|せいしゅん|青春
一天，整日|いちにち|一日
重要，要紧|たいせつだ|大切だ
暑假|なつやすみ|夏休み
度过|すごす|過ごす
留下，留在|のこる|残る
汉语水平考试|エイチエスケー|ＨＳＫ
考试|しけん|試験
接受|うける|受ける
西藏|チベット|チベット
盂兰盆会|おぼん|お盆
到来|くる|来る
万里长城|ばんりのちょうじょう|万里の長城
陪同游览|あんない|案内
是，是吗|そう|そう
好的|よい|良い