首都|しゅと|首都
人口|じんこう|人口
~多|あまり|あまり
~万|まん|万
~人|にん|人
最|もっとも|最も
都市，城市|とし|都市
交通|こうつう|交通
方便|べんりだ|便利だ
街，城镇|まち|町
条，根，只|ほん|本
有名|ゆうめいだ|有名だ
新干线|しんかんせん|新幹線
新宿|しんじゅく|新宿
高层|こうそう|高層
大楼|ビル|ビル
原宿|はらじゅく|原宿
年轻人|わかもの|若者
周末|しゅうまつ|週末
热闹|にぎやかだ|にぎやかだ
清洁，干净|せいけつだ|清潔だ
那样的|そんな|そんな
问题|もんだい|問題
地震|じしん|地震
物价|ぶっか|ぶっか
人们|ひとびと|人々
每天|まいにち|毎日
喜欢|すきだ|すきだ
日语|にほんご|日本語
水平高|じょうずだ|上手だ
还（×2）|まだまだ|まだまだ
很|とても|とでも
难的|むずかしい|難しい
不过，可是|でも|でも
真|ほんとうだ|本当だ
游泳|すいえい|水泳
特别喜欢|だいすきだ|大好きだ
经常地，很好地|よく|よく
游泳池|プール|プール
这次，下次|こんど|今度
星期日|にちようび|日曜日
一起，一同|いっしょ|一緒
个人电脑|パソコン|パソコン
因特网|インターネット|インターネット
做，干，搞|する|する